		NO ./Images/n_wall.xpm
		SO       ./Images/s_wall.xpm
		WE ./Images/w_wall.xpm
		EA ./Images/e_wall.xpm

F 255,0,0
C 0,0,255

        1111111111111111111111111
        1000000000110000000000001
        1011000001110000000100001
        100100000000000000W000001
111111111111000001110000000000001
100000000011000001110111111111111
11110111111111011100000010001
11110111111111011101010010001
11000000110101011100000010001
10000000000000001100000010001
10000000000000001101010010001
1100000111010101111101111000111
11110111 1110101 101111010001
11111111 1111111 111111111111