NO ./Images/n_wall.xpm
SO ./Images/s_wall.xpm
WE ./Images/w_wall.xpm
EA ./Images/e_wall.xpm

C 58,50,45
F 190,200,195

  111111111111111111111
  100000000000001000001
  101001010100100010000111111
1111010010001D1111111100000011
10000010010000000000010111100011
11110100010010100111100000001001
  10W001101000001000001111111001
  101000000010000001D11      101
  101D11111111111111011111111101
11101000000000000000000000000001
11111111111111111111111111111111