NO ./Images/n_wall.xpm
SO ./Images/s_wall.xpm
WE ./Images/w_wall.xpm
EA ./Images/e_wall.xpm

F 245,255,0
C 255,0,255

111111111111111111111
10W000000000001000001
1D1001010100100010001
1010010001011111111D1
101000100000000000101
101000100101001111101
1000011D1000001000001
101000000010000001011
111111111111111111111