NO ./maps/lsd_assets/lsd1.xpm
SO ./maps/lsd_assets/lsd2.xpm
WE ./maps/lsd_assets/lsd3.xpm
EA ./maps/lsd_assets/lsd4.xpm

F 245,255,0
C 255,0,255

111111111111111111111
10W000000000001000001
101001010100100010001
101001000101111111101
101000100000000000101
101000100101001111101
100001101000001000001
101000000010000001011
111111111111111111111