NO ./Images/n_wall.xpm
SO ./Images/s_wall.xpm
WE ./Images/w_wall.xpm
EA ./Images/e_wall.xpm

F 245,255,0
C 255,0,255

1111111
1000001
100N001
1000001
1111111