NO ./Images/n_wall.xpm
SO ./Images/s_wall.xpm
WE ./Images/w_wall.xpm
EA ./Images/e_wall.xpm

F 245,255,0
C 255,0,255

wand - spieler = dir.vect.

1111111
1000001
100N001
1000001
1111111

N{4,-3}
Wand{4, 1}
dir->{0, 2}

S{4, -3}
WAND{4, -5}
dir->{0, -2}

W{4, -3}
WAND{1, -3}
dir->{-3, 0}

E{4, -3}
WAND{7, -3}
dir->{3, 0}













x																	x




									*





x																	x