NO ./Images/n_wall.xpm
SO ./Images/s_wall.xpm
WE ./Images/w_wall.xpm
EA ./Images/e_wall.xpm

F 245,255,0
C 255,0,255

11111111
10000001
1000W001
11D11111
10000001
10011101
10000101
111101D1
11110001
11111111