NO ./Images/n_wall.xpm
SO ./Images/s_wall.xpm
WE ./Images/w_wall.xpm
EA ./Images/e_wall.xpm

F 245,255,0
C 255,0,255

11111111
10000001
1E000001
11111111