NO ./Images/n_wall.xpm
SO ./Images/s_wall.xpm
WE ./Images/w_wall.xpm
EA ./Images/e_wall.xpm

F 2,125,0
C 125,0,255

111111111111111111
100000000000000101
1001100000000001D1
100110000N00100001
100000000000100001
110000111111111111
111111111111111111