NO ./Images/n_wall.xpm
SO ./Images/s_wall.xpm
WE ./Images/w_wall.xpm
EA ./Images/e_wall.xpm

F 2,125,0
C 125,0,255

1111111
1000N01
1000001
1000001
1000001
1000001
1000001
1000001
1000001
1000001
110001111111111111
100000000000000001
100000000000000001
100100000000100001
100000000000100001
110000111111111111
1111111