NO
./textures/redbrick.xpm
SO ./textures/greystone.xpm
WE ./textures/colorstone.xpm
EA ./textures/wood.xpm

F 150,100,100
C 30,30,200

 1111111111111111
10000000000000001
10000000000000001
10000000000000001
10000000000000001
10000000000000001
10000000E00000001
10000000000000001
10000000000000001
10000000000000001
10000000000000001
10000000000000001
11111111111111111